11 7
1 4
5 14 12 12 14 1 6
3 16 16 16 16 16 4
3 16 16 16 15 15 9
3 16 16 16 15 15 9
3 16 16 16 16 16 4
3 18 18 19 16 16 4
3 18 18 19 16 16 4
3 16 16 16 16 16 4
3 16 16 16 16 16 4
3 16 16 16 16 16 4
7 2 13 13 13 2 8

0 0 0 0 0 0 0
0 0 0 0 0 9 0
0 8 0 0 0 0 0
0 0 0 0 0 0 0
0 0 0 0 0 0 0
0 0 0 0 4 0 0
0 0 0 0 4 0 0
0 30 30 30 0 0 0
0 0 0 0 0 0 0
0 5 0 0 0 5 0
0 0 0 0 0 0 0

0 0 0 0 0 0 0
0 0 0 0 0 0 0
0 0 0 0 0 2 0
0 0 0 0 0 2 0
0 2 2 0 0 0 0
0 0 0 0 0 0 0
0 0 0 0 0 0 0
0 0 0 0 0 0 0
0 1 0 0 0 1 0
0 0 0 0 0 0 0
0 0 0 0 0 0 0

12 12 10 10

0 0 0 0 0 0 0
0 1 0 0 0 0 0
0 0 3 2 16 0 0
0 0 0 0 0 0 0
0 0 0 0 0 0 0
0 0 0 0 0 0 0
0 0 0 0 0 0 0
0 0 0 0 0 0 0
0 5 0 0 0 8 0
0 0 1 2 3 0 0
0 0 0 0 0 0 0