11 11
1 4
5 1 1 1 1 1 1 1 1 1 6
3 16 16 16 16 16 16 16 16 16 4 
3 16 16 16 16 16 16 16 16 16 4 
3 16 16 16 16 16 16 16 16 16 4 
11 16 16 16 16 16 16 16 16 16 9 
11 16 16 16 16 16 16 16 16 16 9 
3 16 16 16 16 16 16 16 16 16 4 
3 16 16 16 16 16 16 16 16 16 4 
3 16 16 16 16 16 16 16 16 16 4 
3 16 16 16 16 16 16 16 16 16 4 
7 2 2 2 2 2 2 2 2 2 8

0 0 0 0 0 0 0 0 0 0 0
0 3 3 12 13 14 31 32 3 3 0
0 0 0 0 0 0 0 0 0 0 0
0 5 0 0 0 0 0 0 0 5 0
0 0 0 0 0 0 0 0 0 0 0
0 0 0 0 0 0 0 0 0 0 0
0 0 0 0 0 0 0 0 0 0 0
0 12 0 0 0 0 0 0 0 14 0
0 1 1 1 1 0 1 1 1 1 0
0 0 0 0 0 0 0 0 0 0 0
0 0 0 0 0 0 0 0 0 0 0

0 0 0 0 0 0 0 0 0 0 0
0 0 0 0 0 0 0 0 0 0 0
0 0 0 0 0 0 0 0 0 0 0
0 0 0 0 0 0 0 0 0 0 0
0 2 0 0 0 0 0 0 0 2 0
0 2 0 0 0 0 0 0 0 2 0
0 0 0 0 0 0 0 0 0 0 0
0 0 0 0 0 0 0 0 0 0 0
0 0 0 0 0 0 0 0 0 0 0
0 0 0 0 0 0 0 0 0 0 0
0 0 0 0 0 0 0 0 0 0 0

11 13 11 13

0 0 0 0 0 0 0 0 0 0 0
0 0 0 0 0 0 0 0 0 0 0
0 0 0 0 0 0 0 0 0 0 0
0 0 0 0 0 0 0 0 0 0 0
0 0 0 0 0 0 0 0 0 0 0
0 0 0 0 0 0 0 0 0 0 0
0 0 0 0 0 0 0 0 0 0 0
0 0 0 0 0 0 0 0 0 0 0
0 0 0 0 0 0 0 0 0 0 0
0 0 0 0 0 0 0 0 0 0 0
0 0 0 0 0 0 0 0 0 0 0