9 8
3 7
5 1 1 1 1 1 1 6
3 0 0 0 0 0 0 4
3 0 0 0 0 0 0 4
3 0 0 0 0 0 0 4
3 0 0 0 0 0 0 4
3 0 0 0 0 0 0 4
3 0 0 0 0 0 0 4
3 0 0 0 0 0 0 4
7 2 2 10 10 2 2 8

0 0 0 0 0 0 0 0
0 3 3 3 3 13 4 0
0 0 0 0 0 0 0 0
0 0 3 3 0 3 3 0
0 0 0 0 0 0 0 0
0 3 3 0 3 3 0 0
0 0 0 0 0 0 0 0
0 2 3 0 0 3 2 0
0 0 0 0 0 0 0 0

0 0 0 0 0 0 0 0
0 0 0 0 0 0 0 0
0 0 0 0 0 0 0 0
0 0 0 0 0 0 0 0
0 0 0 0 0 0 0 0
0 0 0 0 0 0 0 0
0 0 0 0 0 0 0 0
0 0 0 2 2 0 0 0
0 0 0 0 0 0 0 0

7 7

0 0 0 0 0 0 0 0
0 0 0 0 0 0 0 0
0 3 1 1 1 0 0 0
0 0 0 0 6 0 0 0
0 3 0 0 0 0 0 0
0 0 0 2 0 0 0 0
0 3 0 1 1 0 0 0
0 0 0 0 0 0 0 0
0 0 0 0 0 0 0 0