10 15

5 1 14 14 14 14 1 1 1 1 14 14 1 14 6
3 0 0 0 0 0 0 0 0 0 0 0 0 0 4
3 0 0 0 0 0 0 0 0 0 0 0 0 0 4
3 0 0 0 0 0 0 0 0 0 0 0 0 0 4
3 0 0 0 0 0 0 0 0 0 0 0 0 0 4
3 0 0 0 0 0 0 0 0 0 0 0 0 0 4
3 0 0 0 0 0 0 0 0 0 0 0 0 0 4
3 0 0 0 0 0 0 0 0 0 0 0 0 0 4
3 0 0 0 0 0 0 0 0 0 0 0 0 0 4
7 2 2 2 2 2 2 2 2 2 2 2 10 2 8

0 0 0 0 0 0 0 0 0 0 0 0 0 0 0
0 24 10 23 23 0 6 7 0 0 4 0 8 17 0
0 0 0 0 0 0 0 0 0 0 0 0 0 0 0
0 0 0 0 0 0 0 0 0 0 0 0 0 14 0
0 0 11 0 1 1 0 19 0 0 0 0 0 29 0
0 0 11 0 1 1 0 18 0 0 0 0 0 29 0
0 0 0 0 1 1 0 19 0 20 0 0 0 29 0
0 0 21 22 1 1 0 18 0 20 0 0 0 29 0
0 1 1 1 1 1 0 0 25 26 0 0 0 29 0
0 0 0 0 0 0 0 0 0 0 0 0 0 0 0

0 0 0 0 0 0 0 0 0 0 0 0 0 0 0
0 0 0 0 0 0 0 0 0 0 0 0 0 0 0
0 0 4 0 0 0 0 0 0 0 0 0 0 0 0
0 0 0 0 0 0 0 0 0 0 0 0 0 0 0
0 0 0 0 0 0 0 0 0 0 0 0 0 0 0
0 0 0 0 0 0 0 0 0 0 0 0 0 0 0
0 0 0 0 0 0 0 0 0 0 0 0 0 0 0
0 0 0 0 0 0 0 0 0 0 0 0 0 0 0
0 0 0 0 0 0 0 0 0 0 0 0 2 0 0
0 0 0 0 0 0 0 0 0 0 0 0 0 0 0

15 1 2

0 0 0 0 0 0 0 0 0 0 0 0 0 0 0
0 0 0 0 0 0 0 0 0 0 0 0 0 0 0
0 0 0 0 0 0 0 0 0 0 1 1 1 0 0
0 4 5 11 0 0 0 0 16 16 0 0 1 0 0
0 0 0 0 0 0 0 0 0 0 0 0 1 0 0
0 3 0 0 0 0 2 0 0 0 0 0 1 0 0
0 2 0 0 0 0 2 0 0 0 0 0 1 0 0
0 2 0 0 0 0 3 0 0 0 0 0 1 0 0
0 0 0 0 0 0 3 9 0 0 0 0 0 0 0
0 0 0 0 0 0 0 0 0 0 0 0 0 0 0