22 10
1 10

5 1 1 14 14 12 12 14 14 6
3 16 16 16 16 16 16 16 16 4
3 16 16 16 16 16 16 16 16 4
11 16 16 16 16 16 16 16 16 9
3 16 16 16 16 16 16 16 16 9
3 16 16 16 16 16 16 16 16 4
3 16 16 16 16 16 16 16 16 4
3 16 16 16 16 16 16 16 16 4
3 16 16 16 16 16 17 18 18 4
11 16 16 16 16 16 17 18 18 4
11 16 16 16 16 16 17 18 18 4
3 16 16 16 16 16 17 18 18 4
3 16 16 16 16 16 17 18 18 4
3 16 16 16 16 16 17 18 18 4
3 16 16 16 16 16 16 16 16 4
3 16 16 16 16 16 16 16 16 4
3 16 16 16 16 16 16 16 16 4
3 16 16 16 16 16 16 16 16 4
3 16 16 16 16 16 16 16 16 4
3 16 16 16 16 16 16 16 16 4
3 16 16 16 16 16 16 16 16 4
7 2 2 2 10 10 2 2 2 6

0 0 0 0 0 0 0 0 0 0
0 31 32 0 0 0 0 0 0 0
0 0 0 0 0 0 0 0 0 0
0 0 0 0 0 0 0 0 0 0
0 0 0 0 0 0 0 0 0 0
0 8 0 0 0 0 0 0 9 0
0 8 0 0 0 0 0 0 9 0
0 8 0 0 0 30 30 30 30 0
0 0 0 0 0 30 0 0 0 0
0 0 0 0 0 30 0 0 0 0
0 0 0 0 0 30 0 0 0 0
0 0 0 0 0 30 0 0 0 0
0 0 0 0 0 30 0 0 0 0
0 0 0 0 0 30 0 0 0 0
0 12 0 0 0 0 0 0 0 0
0 13 0 0 0 0 0 0 0 0
0 14 0 0 0 0 0 0 9 0
0 0 0 0 0 0 0 0 9 0
0 4 0 0 0 0 0 0 9 0
0 5 0 0 0 0 0 0 4 0
0 0 0 0 0 0 0 0 0 0
0 0 0 0 0 0 0 0 0 0

0 0 0 0 0 0 0 0 0 0
0 0 0 0 0 2 2 0 0 0
0 0 0 0 0 0 0 0 0 0
0 2 0 0 0 0 0 0 0 0
0 0 0 0 0 0 0 0 0 0
0 0 0 0 0 0 0 0 0 0
0 0 0 0 0 0 0 0 0 0
0 0 0 0 0 0 0 0 0 0
0 0 0 0 0 0 0 2 2 0
0 2 0 0 0 0 0 0 0 0
0 2 0 0 0 0 0 0 0 0
0 0 0 0 0 0 0 0 0 0
0 0 0 0 0 0 0 0 0 0
0 0 0 0 0 0 0 0 0 0
0 0 0 0 0 0 0 0 0 0
0 0 0 0 0 0 0 0 0 0
0 0 0 0 0 0 0 0 0 0
0 0 0 0 0 0 0 0 0 0
0 0 0 0 0 0 0 0 0 0
0 0 0 0 0 0 0 0 0 0
0 0 0 0 0 0 0 0 0 0
0 0 0 0 0 0 0 0 0 0

4 4 9 5 5 2 2

0 0 0 0 0 0 0 0 0 0
0 0 0 0 0 0 0 0 0 0
0 0 0 0 0 0 0 0 0 0
0 0 0 0 0 0 0 0 0 0
0 0 0 0 0 0 0 0 0 0
0 0 0 0 0 0 0 0 0 0
0 0 0 0 0 0 0 0 0 0
0 0 0 0 0 0 0 0 0 0
0 0 0 0 0 0 0 0 0 0
0 0 0 0 0 0 0 0 0 0
0 0 0 0 0 0 0 0 0 0
0 0 0 0 0 0 0 0 0 0
0 0 0 0 0 0 0 0 0 0
0 0 0 0 0 0 0 0 0 0
0 0 0 0 0 0 0 0 0 0
0 0 0 0 0 0 0 0 0 0
0 0 0 0 0 0 0 0 0 0
0 0 0 0 0 0 0 0 0 0
0 0 0 0 0 0 0 0 0 0
0 0 0 0 0 0 0 0 0 0
0 0 0 0 0 0 0 0 0 0
0 0 0 0 0 0 0 0 0 0