7 12 
5 5
5 1 1 1 1 1 1 1 1 1 1 6
3 0 0 0 0 0 0 0 0 0 0 4
3 0 0 0 0 0 0 0 0 0 0 4
3 0 0 0 0 0 0 0 0 0 0 4
3 0 0 0 0 0 0 0 0 0 0 4
3 0 0 0 0 0 0 0 0 0 0 4
7 13 13 13 13 10 10 13 13 13 13 8

0 0 0 0 0 0 0 0 0 0 0 0
0 8 23 9 0 8 23 9 0 8 23 0
0 0 0 0 0 0 0 0 0 0 0 0
0 8 23 9 0 8 23 9 0 8 23 0
0 0 0 0 0 0 0 0 0 0 0 0
0 4 0 0 14 0 0 13 0 0 5 0
0 0 0 0 0 0 0 0 0 0 0 0

0 0 0 0 0 0 0 0 0 0 0 0
0 0 0 0 0 0 0 0 0 0 0 0
0 0 0 0 0 0 0 0 0 0 0 0
0 0 0 0 0 0 0 0 0 0 0 0
0 0 0 0 0 0 0 0 0 0 0 0
0 0 0 0 0 2 2 0 0 0 0 0
0 0 0 0 0 0 0 0 0 0 0 0

2 2

0 0 0 0 0 0 0 0 0 0 0 0
0 0 0 0 1 0 0 0 15 0 0 0
0 0 0 0 0 0 0 0 0 0 0 0
0 0 0 0 0 0 0 0 0 0 0 0
0 0 0 0 0 0 0 0 0 0 5 0
0 0 2 3 0 0 0 0 0 0 0 0
0 0 0 0 0 0 0 0 0 0 0 0