7 8
2 5
5 1 1 1 1 1 1 6
3 16 16 16 16 16 16 4 
3 16 15 16 15 16 16 4 
3 16 16 15 16 16 16 4 
3 16 15 16 15 16 16 4 
3 16 16 16 16 16 16 4
7 13 10 10 13 13 13 8

0 0 0 0 0 0 0 0
0 0 0 0 0 0 0 0
0 0 0 0 0 0 0 0
0 0 0 0 0 0 0 0
0 0 0 0 0 0 0 0
0 0 0 0 0 0 0 0
0 0 0 0 0 0 0 0

0 0 0 0 0 0 0 0
0 0 0 0 0 0 0 0
0 0 0 0 0 0 0 0
0 0 0 0 0 0 0 0
0 0 0 0 0 0 0 0
0 0 2 2 0 0 0 0
0 0 0 0 0 0 0 0

2 2

0 0 0 0 0 0 0 0
0 0 0 0 0 0 0 0
0 0 0 0 0 0 0 0
0 0 0 0 0 0 0 0
0 0 0 0 0 0 0 0
0 0 0 0 0 0 0 0
0 0 0 0 0 0 0 0
