10 11
9 7
5 1 1 1 1 6 5 1 1 1 6
3 0 0 0 0 0 0 0 0 0 4
3 0 0 0 0 0 0 0 0 0 4
3 0 0 0 0 0 0 0 0 0 4
3 0 0 0 0 0 0 0 0 0 4
3 0 0 0 0 0 0 0 0 0 4
3 0 0 0 0 0 0 0 0 0 4
3 0 0 0 0 0 0 0 0 0 9
3 0 0 0 0 0 0 0 0 0 4
7 2 2 2 2 2 2 2 2 2 8

0 0 0 0 0 0 0 0 0 0 0
0 0 0 0 0 30 30 34 34 34 0
0 33 0 30 0 30 30 0 0 0 0
0 30 30 30 0 30 30 0 0 0 0
0 0 0 0 0 30 30 0 0 0 0
0 33 0 30 0 30 30 0 0 0 0
0 30 30 30 0 30 30 0 0 0 0
0 33 0 30 0 30 30 0 0 0 0
0 0 0 0 0 0 0 0 0 0 0
0 0 0 0 0 0 0 0 0 0 0

0 0 0 0 0 0 0 0 0 0 0
0 0 0 0 0 0 0 0 0 0 0
0 0 0 0 0 0 0 0 0 0 0
0 0 0 0 0 0 0 0 0 0 0
0 0 0 0 0 0 0 0 0 0 0
0 0 0 0 0 0 0 0 0 0 0
0 0 0 0 0 0 0 0 0 0 0
0 0 0 0 0 0 0 0 0 2 0
0 0 0 0 0 0 0 0 0 0 0
0 0 0 0 0 0 0 0 0 0 0

3

0 0 0 0 0 0 0 0 0 0 0
0 7 0 0 5 0 0 0 0 0 0
0 0 0 0 0 0 0 0 1 0 0
0 0 0 0 0 0 0 16 0 6 0
0 0 0 0 16 0 0 0 0 0 0
0 2 0 0 0 0 0 0 0 0 0
0 0 0 0 1 0 0 0 0 0 0
0 0 3 0 1 0 0 0 0 0 0
0 4 0 0 0 0 0 0 0 0 0
0 0 0 0 0 0 0 0 0 0 0