17 10

5 14 12 12 14 1 1 1 1 6
3 16 16 16 16 16 16 16 16 4
3 16 16 16 16 16 16 16 16 4
3 16 16 16 16 16 16 16 16 4
3 16 16 16 16 16 16 16 16 4
3 18 18 19 16 16 16 16 16 4
3 18 18 19 16 16 16 16 16 9
3 18 18 19 16 16 16 16 16 9
3 18 18 19 16 16 16 16 16 4
3 18 18 19 16 16 16 16 16 4
3 18 18 19 16 16 16 16 16 4
3 16 16 16 16 16 16 16 16 4
3 16 16 16 16 16 16 16 16 4
3 16 16 16 16 16 16 16 16 4
3 16 16 16 16 16 16 16 16 4
3 16 16 16 16 16 16 16 16 4
7 13 13 13 10 10 13 13 13 8

0 0 0 0 0 0 0 0 0 0
0 4 0 0 5 0 0 31 32 0
0 0 0 0 0 0 0 0 0 0
0 5 0 0 4 0 0 0 0 0
0 30 30 30 30 0 0 0 0 0
0 0 0 0 30 0 0 0 0 0
0 0 0 0 30 19 0 0 0 0
0 0 0 0 30 18 0 0 0 0
0 0 0 0 30 0 0 0 9 0
0 0 0 0 30 0 0 0 9 0
0 0 0 0 30 0 0 0 9 0
0 0 0 0 0 0 0 0 0 0
0 0 0 0 0 0 0 0 0 0
0 8 0 0 0 0 0 0 14 0
0 8 0 0 0 0 0 0 13 0
0 0 0 0 0 0 0 0 12 0
0 0 0 0 0 0 0 0 0 0

0 0 0 0 0 0 0 0 0 0
0 0 0 0 0 0 0 0 0 0
0 0 0 0 0 0 0 0 0 0
0 0 0 0 0 0 0 0 0 0
0 0 0 0 0 0 0 0 0 0
0 2 2 0 0 0 0 0 0 0
0 0 0 0 0 0 0 0 2 0
0 0 0 0 0 0 0 0 2 0
0 0 0 0 0 0 0 0 0 0
0 0 0 0 0 0 0 0 0 0
0 0 0 0 0 0 0 0 0 0
0 0 0 0 0 0 0 0 0 0
0 0 0 0 0 0 0 0 1 0
0 0 0 0 0 0 0 0 0 0
0 0 0 0 0 0 0 0 0 0
0 0 0 0 0 0 0 0 0 0
0 0 0 0 0 0 0 0 0 0

11 1 5
11 2 5
2 1 3
2 1 4

0 0 0 0 0 0 0 0 0 0
0 0 6 0 0 0 5 0 0 0
0 4 0 0 1 0 0 0 1 0
0 0 2 0 0 0 0 16 0 0
0 0 0 0 0 0 0 0 0 0
0 0 0 0 0 0 0 0 0 0
0 0 0 0 0 0 0 0 0 0
0 0 0 0 0 0 0 0 0 0
0 0 0 0 0 0 4 0 0 0
0 0 0 0 0 0 0 3 0 0
0 0 0 0 0 0 2 0 0 0
0 0 0 0 0 0 0 1 0 0
0 0 0 0 0 0 0 0 10 0
0 0 7 0 0 0 0 0 0 0
0 0 0 2 0 1 0 3 0 0
0 0 0 0 4 0 5 0 0 0
0 0 0 0 0 0 0 0 0 0