7 8

5 1 1 1 1 1 1 6
3 16 16 16 16 16 16 4 
3 16 15 16 15 16 16 4 
3 16 16 15 16 16 16 4 
3 16 15 16 15 16 16 4 
3 16 16 16 16 16 16 4
7 13 10 10 13 13 13 8

0 0 0 0 0 0 0 0
0 16 16 24 3 3 12 0
0 0 0 0 0 0 0 0
0 0 0 0 0 0 28 0
0 0 0 0 0 0 27 0
0 5 0 0 0 0 0 0
0 0 0 0 0 0 0 0

0 0 0 0 0 0 0 0
0 0 0 0 0 0 0 0
0 0 0 0 0 0 0 0
0 0 0 0 0 0 0 0
0 0 0 0 0 0 0 0
0 0 2 2 0 0 0 0
0 0 0 0 0 0 0 0

2 16 1
2 17 1

0 0 0 0 0 0 0 0
0 0 0 0 0 0 0 0
0 1 0 0 0 1 0 0
0 0 3 0 0 5 0 0
0 6 0 2 0 0 0 0
0 0 0 0 0 16 0 0
0 0 0 0 0 0 0 0
